Button	KEYWORD1
Event	KEYWORD1
EventInfo	KEYWORD1

PRESS	LITERAL1
RELEASE	LITERAL1
SHORT_RELEASE	LITERAL1
SINGLE_TAP	LITERAL1
DOUBLE_TAP	LITERAL1
HOLD	LITERAL1
LONG_RELEASE	LITERAL1
USER_EVENT	LITERAL1
ALL_EVENTS	LITERAL1

update	KEYWORD2
reset	KEYWORD2
sleep	KEYWORD2
wakeup	KEYWORD2
down	KEYWORD2
pressed	KEYWORD2
released	KEYWORD2
activity	KEYWORD2
triggered	KEYWORD2
gestureStarted	KEYWORD2
gestureIncludes	KEYWORD2
suppressOnce	KEYWORD2
holdDuration	KEYWORD2
doubleTapInterval	KEYWORD2
inverted	KEYWORD2
callback	KEYWORD2

button	KEYWORD2
event	KEYWORD2
